S,E,E,W,E
E,W,E,W,E
E,E,E,E,E
W,W,E,W,E
E,E,E,E,G